"Session","test_contrast","correct_trials","error_trials","standard_contrast","total_trials","performance"
1,"10",106,60,30,166,0.63855421686747
1,"15",111,59,30,170,0.652941176470588
1,"20",114,51,30,165,0.690909090909091
1,"25",122,64,30,186,0.655913978494624
1,"27",149,66,30,215,0.693023255813954
1,"28",152,62,30,214,0.710280373831776
1,"29",159,54,30,213,0.746478873239437
1,"31",184,63,30,247,0.744939271255061
1,"32",172,69,30,241,0.713692946058091
1,"33",150,75,30,225,0.666666666666667
1,"35",132,101,30,233,0.566523605150215
1,"40",113,65,30,178,0.634831460674157
1,"50",106,49,30,155,0.683870967741935
1,"60",105,43,30,148,0.709459459459459
2,"10",24,63,30,87,0.275862068965517
2,"15",24,55,30,79,0.30379746835443
2,"20",23,52,30,75,0.306666666666667
2,"25",31,59,30,90,0.344444444444444
2,"27",38,75,30,113,0.336283185840708
2,"28",40,65,30,105,0.380952380952381
2,"29",44,74,30,118,0.372881355932203
2,"31",30,81,30,111,0.27027027027027
2,"32",32,91,30,123,0.260162601626016
2,"33",33,65,30,98,0.336734693877551
2,"35",30,87,30,117,0.256410256410256
2,"40",26,87,30,113,0.230088495575221
2,"50",23,56,30,79,0.291139240506329
2,"60",22,34,30,56,0.392857142857143
3,"10",63,56,30,119,0.529411764705882
3,"15",63,71,30,134,0.470149253731343
3,"20",73,73,30,146,0.5
3,"25",81,47,30,128,0.6328125
3,"27",92,81,30,173,0.531791907514451
3,"28",91,74,30,165,0.551515151515152
3,"29",114,83,30,197,0.578680203045685
3,"31",100,73,30,173,0.578034682080925
3,"32",85,67,30,152,0.559210526315789
3,"33",78,87,30,165,0.472727272727273
3,"35",70,104,30,174,0.402298850574713
3,"40",61,79,30,140,0.435714285714286
3,"50",60,60,30,120,0.5
3,"60",59,51,30,110,0.536363636363636
4,"10",36,81,30,117,0.307692307692308
4,"15",34,76,30,110,0.309090909090909
4,"20",34,102,30,136,0.25
4,"25",40,103,30,143,0.27972027972028
4,"27",55,91,30,146,0.376712328767123
4,"28",49,74,30,123,0.398373983739837
4,"29",60,92,30,152,0.394736842105263
4,"31",75,96,30,171,0.43859649122807
4,"32",44,110,30,154,0.285714285714286
4,"33",42,89,30,131,0.320610687022901
4,"35",42,125,30,167,0.251497005988024
4,"40",32,89,30,121,0.264462809917355
4,"50",32,59,30,91,0.351648351648352
4,"60",33,52,30,85,0.388235294117647
5,"10",77,77,30,154,0.5
5,"15",81,77,30,158,0.512658227848101
5,"20",88,71,30,159,0.553459119496855
5,"25",99,64,30,163,0.607361963190184
5,"27",104,77,30,181,0.574585635359116
5,"28",116,75,30,191,0.607329842931937
5,"29",135,84,30,219,0.616438356164384
5,"31",134,90,30,224,0.598214285714286
5,"32",108,82,30,190,0.568421052631579
5,"33",88,96,30,184,0.478260869565217
5,"35",89,79,30,168,0.529761904761905
5,"40",74,76,30,150,0.493333333333333
5,"50",73,47,30,120,0.608333333333333
5,"60",76,46,30,122,0.622950819672131
6,"10",61,52,30,113,0.539823008849557
6,"15",64,49,30,113,0.566371681415929
6,"20",67,54,30,121,0.553719008264463
6,"25",70,61,30,131,0.534351145038168
6,"27",93,66,30,159,0.584905660377358
6,"28",91,61,30,152,0.598684210526316
6,"29",95,49,30,144,0.659722222222222
6,"31",117,75,30,192,0.609375
6,"32",90,80,30,170,0.529411764705882
6,"33",80,71,30,151,0.529801324503311
6,"35",69,59,30,128,0.5390625
6,"40",63,56,30,119,0.529411764705882
6,"50",66,38,30,104,0.634615384615385
6,"60",65,37,30,102,0.637254901960784
7,"10",26,39,30,65,0.4
7,"15",27,33,30,60,0.45
7,"20",27,43,30,70,0.385714285714286
7,"25",31,30,30,61,0.508196721311475
7,"27",45,53,30,98,0.459183673469388
7,"28",36,47,30,83,0.433734939759036
7,"29",44,52,30,96,0.458333333333333
7,"31",41,40,30,81,0.506172839506173
7,"32",36,58,30,94,0.382978723404255
7,"33",33,61,30,94,0.351063829787234
7,"35",31,48,30,79,0.392405063291139
7,"40",27,42,30,69,0.391304347826087
7,"50",26,33,30,59,0.440677966101695
7,"60",26,31,30,57,0.456140350877193
8,"10",22,62,30,84,0.261904761904762
8,"15",20,47,30,67,0.298507462686567
8,"20",21,57,30,78,0.269230769230769
8,"25",28,60,30,88,0.318181818181818
8,"27",35,67,30,102,0.343137254901961
8,"28",38,77,30,115,0.330434782608696
8,"29",39,72,30,111,0.351351351351351
8,"31",24,62,30,86,0.27906976744186
8,"32",25,79,30,104,0.240384615384615
8,"33",31,75,30,106,0.292452830188679
8,"35",24,83,30,107,0.224299065420561
8,"40",20,56,30,76,0.263157894736842
8,"50",20,37,30,57,0.350877192982456
8,"60",19,31,30,50,0.38
9,"10",20,48,30,68,0.294117647058824
9,"15",22,51,30,73,0.301369863013699
9,"20",22,58,30,80,0.275
9,"25",27,74,30,101,0.267326732673267
9,"27",29,60,30,89,0.325842696629214
9,"28",29,76,30,105,0.276190476190476
9,"29",42,75,30,117,0.358974358974359
9,"31",50,56,30,106,0.471698113207547
9,"32",39,71,30,110,0.354545454545455
9,"33",35,63,30,98,0.357142857142857
9,"35",24,60,30,84,0.285714285714286
9,"40",24,50,30,74,0.324324324324324
9,"50",23,44,30,67,0.343283582089552
9,"60",21,45,30,66,0.318181818181818
10,"10",72,47,30,119,0.605042016806723
10,"15",70,38,30,108,0.648148148148148
10,"20",72,46,30,118,0.610169491525424
10,"25",75,54,30,129,0.581395348837209
10,"27",91,49,30,140,0.65
10,"28",92,48,30,140,0.657142857142857
10,"29",101,66,30,167,0.604790419161677
10,"31",144,74,30,218,0.660550458715596
10,"32",109,58,30,167,0.652694610778443
10,"33",97,58,30,155,0.625806451612903
10,"35",76,38,30,114,0.666666666666667
10,"40",73,38,30,111,0.657657657657658
10,"50",65,37,30,102,0.637254901960784
10,"60",72,37,30,109,0.660550458715596
11,"10",19,48,30,67,0.283582089552239
11,"15",19,48,30,67,0.283582089552239
11,"20",17,56,30,73,0.232876712328767
11,"25",17,57,30,74,0.22972972972973
11,"27",19,79,30,98,0.193877551020408
11,"28",21,90,30,111,0.189189189189189
11,"29",22,86,30,108,0.203703703703704
11,"31",28,101,30,129,0.217054263565891
11,"32",26,78,30,104,0.25
11,"33",27,57,30,84,0.321428571428571
11,"35",18,57,30,75,0.24
11,"40",22,54,30,76,0.289473684210526
11,"50",18,45,30,63,0.285714285714286
11,"60",18,47,30,65,0.276923076923077
12,"10",81,29,30,110,0.736363636363636
12,"15",77,41,30,118,0.652542372881356
12,"20",78,46,30,124,0.629032258064516
12,"25",103,41,30,144,0.715277777777778
12,"27",114,57,30,171,0.666666666666667
12,"28",122,54,30,176,0.693181818181818
12,"29",139,64,30,203,0.684729064039409
12,"31",122,74,30,196,0.622448979591837
12,"32",121,48,30,169,0.715976331360947
12,"33",97,69,30,166,0.58433734939759
12,"35",82,59,30,141,0.581560283687943
12,"40",77,43,30,120,0.641666666666667
12,"50",79,43,30,122,0.647540983606557
12,"60",77,33,30,110,0.7
13,"10",50,44,30,94,0.531914893617021
13,"15",50,48,30,98,0.510204081632653
13,"20",50,58,30,108,0.462962962962963
13,"25",50,53,30,103,0.485436893203884
13,"27",50,53,30,103,0.485436893203884
13,"28",50,66,30,116,0.431034482758621
13,"29",50,77,30,127,0.393700787401575
13,"31",50,83,30,133,0.37593984962406
13,"32",50,78,30,128,0.390625
13,"33",50,70,30,120,0.416666666666667
13,"35",50,64,30,114,0.43859649122807
13,"40",50,54,30,104,0.480769230769231
13,"50",50,48,30,98,0.510204081632653
13,"60",50,47,30,97,0.515463917525773
14,"10",29,32,30,61,0.475409836065574
14,"15",32,27,30,59,0.542372881355932
14,"20",28,32,30,60,0.466666666666667
14,"25",32,40,30,72,0.444444444444444
14,"27",34,40,30,74,0.459459459459459
14,"28",46,31,30,77,0.597402597402597
14,"29",41,42,30,83,0.493975903614458
14,"31",60,64,30,124,0.483870967741935
14,"32",49,36,30,85,0.576470588235294
14,"33",43,31,30,74,0.581081081081081
14,"35",33,43,30,76,0.434210526315789
14,"40",31,32,30,63,0.492063492063492
14,"50",30,31,30,61,0.491803278688525
14,"60",26,25,30,51,0.509803921568627
15,"10",68,31,30,99,0.686868686868687
15,"15",65,35,30,100,0.65
15,"20",69,31,30,100,0.69
15,"25",79,42,30,121,0.652892561983471
15,"27",97,43,30,140,0.692857142857143
15,"28",89,41,30,130,0.684615384615385
15,"29",96,44,30,140,0.685714285714286
15,"31",92,52,30,144,0.638888888888889
15,"32",102,52,30,154,0.662337662337662
15,"33",86,48,30,134,0.641791044776119
15,"35",75,36,30,111,0.675675675675676
15,"40",68,37,30,105,0.647619047619048
15,"50",67,38,30,105,0.638095238095238
15,"60",69,36,30,105,0.657142857142857
16,"10",110,41,30,151,0.728476821192053
16,"15",112,43,30,155,0.72258064516129
16,"20",117,42,30,159,0.735849056603774
16,"25",134,41,30,175,0.765714285714286
16,"27",160,57,30,217,0.737327188940092
16,"28",159,71,30,230,0.691304347826087
16,"29",191,61,30,252,0.757936507936508
16,"31",168,84,30,252,0.666666666666667
16,"32",150,45,30,195,0.769230769230769
16,"33",128,59,30,187,0.684491978609626
16,"35",122,59,30,181,0.674033149171271
16,"40",113,41,30,154,0.733766233766234
16,"50",113,41,30,154,0.733766233766234
16,"60",112,40,30,152,0.736842105263158
17,"10",50,30,30,80,0.625
17,"15",50,40,30,90,0.555555555555556
17,"20",52,33,30,85,0.611764705882353
17,"25",60,39,30,99,0.606060606060606
17,"27",61,58,30,119,0.512605042016807
17,"28",73,46,30,119,0.613445378151261
17,"29",77,68,30,145,0.531034482758621
17,"31",83,70,30,153,0.542483660130719
17,"32",70,56,30,126,0.555555555555556
17,"33",72,54,30,126,0.571428571428571
17,"35",61,44,30,105,0.580952380952381
17,"40",49,39,30,88,0.556818181818182
17,"50",49,40,30,89,0.550561797752809
17,"60",49,33,30,82,0.597560975609756
18,"10",70,22,30,92,0.760869565217391
18,"15",68,19,30,87,0.781609195402299
18,"20",68,27,30,95,0.715789473684211
18,"25",82,27,30,109,0.752293577981651
18,"27",98,36,30,134,0.73134328358209
18,"28",106,34,30,140,0.757142857142857
18,"29",113,46,30,159,0.710691823899371
18,"31",109,38,30,147,0.741496598639456
18,"32",90,34,30,124,0.725806451612903
18,"33",80,43,30,123,0.650406504065041
18,"35",76,33,30,109,0.697247706422018
18,"40",69,26,30,95,0.726315789473684
18,"50",67,19,30,86,0.779069767441861
18,"60",71,27,30,98,0.724489795918367
19,"10",84,44,30,128,0.65625
19,"15",88,39,30,127,0.692913385826772
19,"20",85,47,30,132,0.643939393939394
19,"25",91,50,30,141,0.645390070921986
19,"27",98,55,30,153,0.640522875816993
19,"28",123,60,30,183,0.672131147540984
19,"29",138,80,30,218,0.63302752293578
19,"31",156,83,30,239,0.652719665271967
19,"32",129,61,30,190,0.678947368421053
19,"33",114,73,30,187,0.609625668449198
19,"35",99,50,30,149,0.664429530201342
19,"40",86,44,30,130,0.661538461538462
19,"50",85,37,30,122,0.69672131147541
19,"60",86,37,30,123,0.699186991869919
20,"10",72,36,30,108,0.666666666666667
20,"15",73,32,30,105,0.695238095238095
20,"20",68,36,30,104,0.653846153846154
20,"25",88,37,30,125,0.704
20,"27",90,44,30,134,0.671641791044776
20,"28",107,59,30,166,0.644578313253012
20,"29",97,60,30,157,0.617834394904459
20,"31",113,87,30,200,0.565
20,"32",103,58,30,161,0.639751552795031
20,"33",108,51,30,159,0.679245283018868
20,"35",82,35,30,117,0.700854700854701
20,"40",74,39,30,113,0.654867256637168
20,"50",72,37,30,109,0.660550458715596
20,"60",71,32,30,103,0.689320388349515
21,"10",31,32,30,63,0.492063492063492
21,"15",30,45,30,75,0.4
21,"20",33,32,30,65,0.507692307692308
21,"25",32,47,30,79,0.40506329113924
21,"27",45,31,30,76,0.592105263157895
21,"28",45,49,30,94,0.478723404255319
21,"29",62,55,30,117,0.52991452991453
21,"31",47,48,30,95,0.494736842105263
21,"32",49,43,30,92,0.532608695652174
21,"33",35,55,30,90,0.388888888888889
21,"35",31,42,30,73,0.424657534246575
21,"40",34,30,30,64,0.53125
21,"50",31,29,30,60,0.516666666666667
21,"60",32,29,30,61,0.524590163934426
